{
  "mapName": "Corridor Blitz",
  "mapArray": [
    [0,35,36,36,36,36,36,36,36,36,36,39],
    [21,35,37,37,37,37,37,37,37,37,37,41],
    [36,0,0,11,0,0,0,0,0,0,6,0],
    [48,41,8,0,0,0,20,1,0,0,0,12],
    [0,0,0,0,47,28,43,43,43,45,0,0],
    [49,35,0,0,42,13,13,13,11,22,0,0],
    [50,35,0,0,42,10,0,0,11,42,20,0],
    [0,0,0,20,42,10,19,0,11,42,0,0],
    [51,39,0,0,25,10,12,12,12,42,0,0],
    [37,0,0,0,44,43,43,43,31,46,0,0],
    [52,35,13,0,0,0,0,20,2,0,0,9],
    [0,35,0,6,0,0,0,0,0,0,10,0]
  ]
}
