{
  "mapName": "Sprint Cramp",
  "mapArray": [
    [0,35,36,36,36,36,36,36,36,36,36,39],
    [21,35,37,37,37,37,37,37,37,37,37,41],
    [36,0,0,11,0,0,0,0,0,10,0,0],
    [48,41,0,11,0,7,8,8,0,10,12,12],
    [0,0,12,12,2,7,0,6,0,0,0,0],
    [49,35,0,0,7,8,0,6,8,8,8,0],
    [50,35,0,7,8,0,0,0,0,0,6,0],
    [0,0,0,7,0,0,0,0,0,9,6,0],
    [51,39,0,9,9,9,7,0,9,6,0,0],
    [37,0,0,0,0,0,7,0,6,0,13,13],
    [52,35,13,13,11,0,9,9,6,0,10,1],
    [0,35,0,3,11,0,0,0,0,0,10,0]
  ]
}
