{
  "mapName": "Test Map",
  "mapArray": [
    [21,48,49,50,51,52,0,16,34,16,0,17],
    [0,0,0,0,0,0,37,37,0,0,0,0],
    [1,2,3,4,5,0,6,10,0,20,0,14],
    [0,0,0,0,0,0,0,0,0,15,0,0],
    [7,0,8,0,9,0,10,0,38,0,39,15],
    [0,0,0,0,0,0,0,0,0,19,0,18],
    [11,0,12,0,13,0,6,0,40,0,41,0],
    [0,0,0,0,0,0,0,0,22,37,47,8],
    [0,23,0,24,0,34,35,0,42,0,42,0],
    [0,36,0,36,0,0,0,0,46,36,25,0],
    [28,43,45,0,44,43,31,0,0,0,0,0],
    [0,0,15,0,0,0,0,9,20,0,12,0]
  ]
}
